16
0 0 11 0 0 0 4 5 0 15 13 6 0 0 8 7 
13 5 0 4 0 12 0 0 0 0 7 0 15 0 2 6 
0 3 0 0 9 0 6 0 0 0 0 10 14 0 0 1 
6 2 0 0 3 7 13 15 0 0 4 0 0 12 5 9 
3 6 0 0 0 0 0 0 4 16 0 0 13 0 12 0 
8 12 10 0 6 5 9 0 0 0 15 0 3 0 4 16 
11 0 0 5 0 13 16 0 0 0 0 8 10 14 6 15 
0 4 0 15 14 2 3 0 10 0 6 5 9 0 0 11 
0 0 0 0 13 0 2 0 0 4 0 11 0 0 0 0 
0 0 0 0 0 15 0 12 6 1 8 13 4 9 0 0 
5 8 6 9 4 3 0 0 15 0 10 0 12 0 0 0 
0 0 14 1 8 0 10 0 5 0 16 12 6 15 0 0 
0 16 5 0 15 0 0 10 3 11 0 0 0 0 9 0 
14 0 3 0 2 0 12 0 0 10 5 0 0 0 0 0 
12 0 0 13 5 14 11 3 0 8 1 9 0 0 0 0 
2 0 15 0 0 9 0 0 7 0 12 0 5 1 0 0 
