16
1 0 7 0 0 3 0 0 11 0 0 0 0 16 4 0 
2 0 8 0 0 0 15 0 14 0 0 4 0 0 0 7 
13 0 0 0 0 0 2 14 1 3 0 0 0 0 0 15 
15 11 0 0 0 7 0 0 0 5 0 13 14 0 0 2 
0 0 3 0 0 12 0 0 13 0 0 16 2 0 15 0 
16 4 0 0 0 2 0 9 0 0 15 1 5 0 0 0 
0 0 0 0 16 5 14 15 0 2 4 0 0 0 0 0 
0 15 0 2 0 0 4 0 0 0 0 0 16 9 13 0 
14 3 9 13 7 0 0 0 0 0 11 0 0 0 0 0 
0 0 0 7 10 0 0 0 0 12 0 15 0 5 9 0 
0 0 0 0 9 0 0 3 0 13 7 14 12 2 0 0 
0 0 0 15 0 0 0 16 6 0 0 0 10 14 7 0 
0 0 13 16 15 11 0 0 4 0 0 0 0 0 0 14 
0 10 5 0 0 0 0 0 7 0 6 0 0 13 0 4 
0 2 0 0 0 0 3 0 16 11 0 0 0 0 10 9 
0 0 0 14 13 0 7 2 15 0 10 0 0 0 0 0 
