16
0 0 0 0 11 0 16 0 9 13 0 0 0 7 14 0 
0 0 0 0 7 0 4 0 3 2 6 0 9 5 12 0 
9 0 11 8 1 0 0 3 14 4 7 0 15 0 16 0 
14 0 0 0 15 0 5 0 0 1 0 8 0 0 11 4 
0 0 0 0 16 0 1 14 0 0 12 0 11 4 0 13 
0 7 13 0 0 0 8 11 0 0 0 0 1 9 0 2 
3 0 4 0 0 0 0 0 0 0 0 16 10 0 0 0 
6 0 14 0 9 0 7 4 13 11 8 0 0 0 3 16 
5 0 6 0 0 11 0 2 4 0 13 9 7 3 0 15 
10 0 9 0 0 0 6 0 2 0 3 7 8 0 1 0 
7 4 8 0 3 16 0 0 0 0 1 0 0 2 13 0 
0 0 0 0 10 7 13 0 8 5 11 0 0 0 6 0 
16 0 0 7 14 4 0 0 0 0 0 0 6 8 0 0 
2 0 0 6 0 0 0 16 7 8 5 1 0 0 4 11 
13 3 12 4 5 1 0 8 0 0 0 0 16 0 2 7 
11 8 5 0 2 0 0 7 0 0 4 0 0 1 9 12 
