16
4 9 8 0 A 0 6 F 0 0 0 0 1 0 0 7 
0 D 0 0 0 8 G 0 0 2 5 0 6 9 A 0 
0 0 0 0 0 0 7 D 0 0 A 1 G 4 8 C 
6 G A 0 0 0 9 0 0 0 7 D 0 0 B 5 
0 0 6 F 0 0 0 0 1 E 9 0 C 8 0 A 
0 0 1 0 C 0 0 6 7 4 B 0 0 5 0 D 
3 0 0 0 9 1 0 0 0 A 0 F B 0 7 6 
0 B 0 D E A 3 7 8 6 0 0 0 0 0 0 
B C 5 G F 0 0 2 0 0 0 A E 0 0 0 
0 0 0 8 0 D 0 0 2 0 F 0 5 3 6 G 
2 0 D 0 G 3 0 0 B 7 E 0 0 0 1 0 
9 0 0 3 8 0 0 E G 0 0 6 0 2 D 0 
0 8 F 0 0 0 0 3 0 1 0 5 D B C 0 
D 2 0 6 0 7 8 0 9 0 0 0 0 A 0 3 
0 3 B 4 0 9 D A 0 0 2 8 0 0 0 0 
A 0 0 5 B F C 0 3 D 0 7 0 0 0 0 
