16
3 0 D 0 0 0 7 0 B 0 0 0 0 0 0 0 
0 6 0 0 A 0 0 0 5 0 0 0 C D G 0 
C 0 0 2 0 6 0 0 0 0 3 0 0 5 0 F 
B 0 4 0 0 0 0 0 D 9 0 0 0 A 0 8 
0 G B 0 0 0 0 0 7 0 D 9 1 0 5 E 
F 0 0 0 E 0 0 1 0 0 8 3 0 0 0 0 
0 0 0 0 0 0 D 9 0 2 0 0 G 0 0 6 
0 0 0 0 0 0 0 0 0 0 0 1 3 0 8 4 
G 0 A D 0 0 0 6 0 0 0 0 0 0 0 0 
1 B 0 0 7 0 9 0 0 0 0 0 0 0 0 0 
0 7 0 0 0 C 0 0 0 1 0 0 0 3 0 0 
0 0 6 3 0 0 0 0 8 0 0 0 0 0 1 0 
0 0 G A B 0 6 0 0 0 0 0 0 0 0 0 
0 0 9 0 0 E 1 7 0 0 0 0 0 0 0 0 
6 0 0 E 0 0 8 0 0 0 A 0 0 0 0 0 
0 0 0 0 0 9 4 0 0 D 0 8 0 0 0 0 
