16
0 0 7 0 0 15 0 0 2 0 6 3 13 0 4 0 
0 0 0 13 5 7 16 0 4 9 0 0 0 0 0 0 
0 0 2 0 0 10 0 4 0 0 0 0 0 12 0 7 
1 0 4 0 13 12 0 2 0 16 14 0 0 0 0 0 
7 0 0 0 0 6 0 0 0 1 2 14 5 0 13 9 
0 0 13 0 8 1 12 11 0 0 0 0 0 0 0 2 
0 3 0 1 16 14 0 5 0 13 7 0 0 15 11 0 
15 0 10 2 4 9 7 0 11 0 0 5 12 16 0 6 
0 0 5 15 0 11 6 0 0 8 1 9 0 0 0 4 
0 7 0 0 14 0 0 3 15 2 16 0 11 5 0 8 
12 0 8 3 0 2 0 15 0 0 0 4 6 1 10 14 
0 2 6 11 0 0 0 8 0 5 0 10 7 0 15 13 
0 0 3 8 0 5 0 0 0 0 0 11 0 0 6 15 
5 13 14 10 0 4 0 6 9 15 12 0 2 3 0 0 
0 1 0 7 0 0 0 9 8 0 0 0 0 0 14 12 
0 0 0 0 15 8 11 0 0 0 13 1 0 10 7 5 
