16
0 0 13 0 16 14 0 10 0 0 2 0 0 4 0 8 
0 0 16 0 0 0 0 13 0 0 0 4 11 7 0 0 
7 0 10 0 0 0 1 0 0 8 0 6 0 14 13 9 
0 0 0 15 0 0 0 0 0 5 13 0 0 0 2 0 
0 14 1 0 9 0 13 0 0 0 0 0 0 11 0 0 
10 0 9 3 0 0 0 7 0 0 0 0 1 5 0 13 
12 4 0 0 1 0 0 0 0 9 14 0 0 0 8 15 
0 13 15 6 4 0 0 5 11 0 3 0 12 9 7 2 
0 0 0 16 13 0 8 11 7 14 0 2 0 12 0 10 
2 0 7 10 6 12 0 14 8 3 11 0 0 15 0 0 
0 0 0 0 2 5 16 0 0 0 9 1 0 6 11 7 
13 9 4 11 0 7 3 0 0 0 5 0 2 8 0 14 
9 7 3 4 0 0 5 1 0 11 0 10 14 0 15 6 
0 2 12 8 14 0 0 0 3 16 0 0 9 0 0 0 
15 0 11 0 8 16 0 2 0 13 0 0 0 1 0 12 
1 0 0 0 3 0 10 9 0 0 7 14 8 2 0 11 
