16
0 0 0 0 0 0 0 0 9 10 0 6 0 0 0 16 
0 11 0 14 0 0 0 0 0 0 0 8 0 3 0 0 
0 4 0 9 15 0 16 0 0 0 0 0 0 0 0 0 
0 0 10 0 0 0 0 8 14 11 0 0 0 0 1 13 
6 0 0 0 0 13 12 0 0 0 0 0 9 0 10 0 
0 0 15 0 0 0 0 0 0 9 7 0 12 0 0 0 
13 0 0 0 0 0 0 0 12 0 0 0 16 4 8 3 
9 0 0 1 0 7 10 0 13 0 0 4 0 2 0 0 
0 9 0 0 7 0 0 11 0 12 14 0 0 0 0 0 
0 16 0 0 0 0 0 13 0 0 0 0 0 12 15 0 
0 0 0 6 0 5 0 9 15 0 0 0 14 0 0 0 
0 0 3 13 0 0 0 0 0 0 0 10 0 0 9 0 
0 6 0 0 0 11 14 0 0 0 0 0 4 0 16 12 
0 0 0 0 13 0 0 10 0 16 12 0 0 0 0 0 
11 0 0 0 0 0 0 12 0 0 5 14 0 0 0 0 
0 0 14 0 9 0 0 0 11 0 0 15 0 0 0 0 
